** **
*  **
* ***
*   *
*** *
*   *
** **
 